             .......                                                                      
           ...................                                                     ...... 
          ......:..........................                 ............................. 
         ......-===----:::::...............   ...... ...................................  
         .....:===============----::::::...  ..........................................   
           ..:=============================.:=---------------..........................   
       ......-==============================================-.........................    
      ......-===============================================:........................     
      .....:===============================================-.........................     
     ......-=========**========+*+=========================:........................      