
     .....-=======+*####*+===*####*+======================:.........................      
    .....:======+#########**########+====================:.........................       
    .....-========+###############*====================-:..........................       
   .....:===========+###########*====================-:...........................        
   .....-==========+#############*+================-:.............................        
      ..========+*#################*+====#%%%==--*+=-::...........................        
        .:-======+*######*=+*######*=====*##*::.=@@@@@@@:...:-:..................         
  .....-===========+*##+======+*#*========:.......:--=+=....+@@%*=...............         
   ....=================================-...................-=*%@@@#=..........           
     .:================================-........................:=#@#-.......                      