
 .....:===============================:.........................................          
 ......::-===========================:.................................:-.......          
 ..........:--=====================-..................................@@@.......          
..............::-===============-:...................................:@@@. .....          
..................::----==---::......................................#@@+  .....          
....................................................................*@@*.  .....          
.....................................................................--.   .....          
...........................................................:=+#%+:......   .....          
....................................::::::....--====+:....=@@@@#+-......   .....          
...........................-=-...:%@@@@@@#....*@@@@@@#:....:-............ ......          
........................+#@@@@:...=++====-....:--:::............................             