
      ....         ...:=:.........................................................        
     .....          .*@@@@#*+-....................................................        
   .......          ...-+*%@@=...:@@@@@@%=...:++=-::..............................        
    .......        .........:....:+++****-...-@@@@@@%:...::........................       
                  .............................:-==+*:...+@%*+-:...................       
    ..........  .........................................-*#@@@@%*=:................      
    .........................................................:=*%@@#:...............      
     .............................................................:..................     
     .................................................................=%@+...........     
      ................::--------::::.........:::---===---:............:#@@*...........    
      ...........::-===================---=================-:...........*@@=..........    
       ........:=============================================-...  ......... ..........   
        ......-===============================================-...   ....     .........   
        ......:====:=====================-----::::::::............    ..................  