
........................:##+-:..................................................          
..................-##:..........................................................          
.................*@@@=..........................................................          
...............-%@@+............................................................          
...............-=+-.............................................................          
 .............................................................................            
 .......  ...:=-:..............................................................           
 .......    .:@@%................................................................         
 ........   ..#@@=...........................................................             
  .......    ..%@@*..............................................................         
  .......      .+=:..............................................................         